20
10
11111111100111111111
10e00000000000000001
10000000000000000001
10000000000000000001
00000000000000000000
00000000000000000000
10000000000000000001
10000000000000000001
100000000e0000000001
11111111100111111111